HOW? - An inquisitorial statement inquiring for more information (My tape been done, last year)
Geoffrey Chaucer - 14th-century English poet who is responsible for The Canterbury Tales, The Nuns Priest Tale, and the cult of Mark Rankin (Fuck Mark Rankin (8head bumler))
Javelin - A weapon reminiscent of a spear or a rocket launcher
Jauser - Chaucer variant
J/M/B/Chaulser - Chaucer variant
Jaulmer - Chaucer variant
Jaulker - Chaucer variant
Chaulmer(s) - Chaucer variant
The Wood - Crazy natural Febreeze scent
The Air - Crazy natural Febreeze scent
Jaulp - Lying/Trolling in an unproductive yet comedic way
Jaulping - The verb form of Jaulp
Jaulper - One who Jaulps
Scalp - The skin covering the head, excluding the face
Scalping - The verb form of Scalp
Scalper - One who scalps
Maulp - Malignant Jaulp
Maulping - The verb form of Maulp
Maulper - One who Maulps
Shuster - KJ alter ego
Bluster - KJ alter ego
Sheister - KJ alter ego
Fredi - Ethan alter ego
Fredlore - Ethan alter ego
Fredillion - Ethan alter ego
Fredlorish - Something with a quality that is indicative of Fredlore
Glo - Rowan alter ego
Globob - Rowan alter ego
Glo Bobineaux/Babineaux/Bumineaux/Babbileaux/Botineaux - Rowan alter ego
Glo Babbler - Rowan drunk chirping alter ego
Tik Tokineaux - Rowan alter ego
Corn Ballineaux - Rowan alter ego
Globobish - Something with a quality that is indicative of Globob
Globobbing - An act of Globobery
Homer Simpson - Cort alter ego
Ron/Ronald - Brennan alter ego
Ronald Weezlir - Brennan alter ego
Ronald Cheezlir - Brennan alter ego
Cheeseman - Brennan alter ego
Slush - Josh alter ego
Chester Jaulpington - Josh alter ego
Lester Scalpington - Josh alter ego
S/J/M/Valug - Josh alter ego
JB - Jakob Bowen alter ego
GayB - Jakob Bowen gay alter ego
JB^2 - Jacob Bickmore alter ego
Cucumber Joe - Joe alter ego
WB - Will Bowen alter ego
Crater Creator - Will Bowen alter ego
Chestlore - Hitting chest at the gym
Folk/Fjolk/Pholque - Someone of close relation to the speaker
Chester - An exclamatory statement indicating the mood of the speaker
Jester - An exclamatory statement indicating the mood of the speaker
Lester - An exclamatory statement indicating the mood of the speaker
Chether - Chester variant
Leather - A material made from the skin of an animal by tanning or a similar process
Skether - A skethacious-looking character
Chething - An act of Chethery
Skething - An act of Skethery
The Meat Thermometer - A cooking tool used to gauge the temperature of meat
The Mourning Wood - Terraria Halloween event boss in the form of a tree
The Pumpking - Terraria Halloween event boss in the form of a pumpkin
Dawson/Dawzen/Dowsen - Dolansky nik
Dolansker - Dawzen
So its Cap Day - A reactionary exclamation when the speaker determines cap has been stated
Wingdings - Chicken wings
Mao Zedong - 20th-century Chinese dictator
Mao Zebard/Chime Minister - Steve Andreas playing Bard in LoL
Baja Blast - Crazy tropical-flavored Mountain Dew soda
Bum - A person who avoids work and sponges on others
Bumluss - One who is a Bum
Bim Lum - Highest caste, top of the bum hierarchy
Chim Lum - Middle caste, and middle of the bum hierarchy
Bum Chum - Lowest caste, the bottom of the bum hierarchy
Come Forth - The verbal summoning of an entity to the speakers location
Stay Put - The opposite of coming forth
Sour Monkey/Sauer Monchee/Zour Mohnchie - Craft IPA
Tweezer - Twisted Tea
Thomas - Bagels
Martins - Potato Rolls/Chips/Store
B/S/Paul Henriksen - JMU ISAT professor
Wheysir - Protein powder
Slugfest - An event where much alcohol is consumed
Bau(l)sir/Balzer/Ballzir/Ballsir - A reactionary exclamation
The Phish Phinder - Terraria item
The Terraformer - Apex area
The Shellphone - Terraria Item
Faucet Failure - An event in which the faucet fails
Pumpernickel - Shit bread
Gallikers - Sheetz milk
Caliber - Desiigner earrape
Funnel - Inverted cone and tube-shaped alcohol drinking apparatus (Equivalent to 1 standard drink)
Dunnel - Double funnel (Equivalent to 2 standard drinks)
Trunnel - Triple funnel (Equivalent to 3 standard drinks)
Inside the Backrooms - Liminal game where you try to escape the backrooms
Almond Water - Inside the Backrooms item
Xanz - Inside the Backrooms item
Moth Jelly - Inside the Backrooms item
Granny - Crazy escape room game (severely underrated)
Annies - White cheddar mac n cheese
Cookout/Cookelt/Gookout - Fast food restaurant chain with a vast menu
Deli Mex - Taquitos
Fridays - Boneless chicken nuggets
Arbys - Curly fries
Martian Saucer/Marshian Souwcer - Terraria Boss
The Moon/Coom Lord - Terraria Boss
Doom/Coom Eternal - Crazy FPS game (Rip and tear)
Farmer John/Jawn/Jean - Parmesan cheese
Britter - Brita filter
Oikos - Yogurt
George Foreman/4nem - Former Professional Boxer and Entrepreneur
George 4nem Grill - As seen on TV garbage
Forge Geornem - George 4nem alter ego
Zalsa - Mexican chip dip (not guac)
The Orbiter - MW2 Kastov 545 blueprint
The Bryson - MW2 Shotgun
Chester Jet - MW2 VTOL
Chester Mines - MW2 Cluster mines
Chester Gunner - MW2 and BO6 Chopper Gunner
Huell Babineaux - Crazy BB/BCS character
Jewsir - Someone who is a Jew
Merree Monchee/Merry Monkey - Christmas variant of Sour Monkey
Sawtooth/Zatooth Bracket - Picture hanging item
Jaulmer Springs, NY - The sacred and holy birthplace of Jaulses Chest, the origin of Jaulping
Jaulses Chest - Folklorish religious deity; Inspired by Jesus Christ
The Old Chestament - This dictionary; The combined history of Folklorish
The New Chestament - The Grog Log and the Farm combined
Maulp/Poptropica - Old fire online game
Uncouth - Lacking good manners
Mingle - To associate with other previously unknown individuals
Co/Costco - Wholesale warehouse
Kirkland Sport Drink - Co Gatorade
Za - pizza/weed
Chicken Bake - Co food court item
Sloker - Poker
Bumlish - Someone with the quality of a bum (Bumlik)
Bumlik/Bhumik - Rons old roommate (Stinker)
Bumler - Someone who frequently engages in bumlish acts
Reechird - Farm Client
The Richard/Reechird - The Boof
Taco(s) Tuesday - B00n House Traditional Taco Dinner and potential slugfest
Hidden Valley - Ranch
Stouffers - Microwavable food
Golden China - Oriental Buffet
Mr. Js - Bagel Store
Bungalo Bimlo - Smite Trog
Bumbalo Bimlims - Smite Trog
The Window Pounder - Rusty Driver (Retard 12 (not for much longer))
Slim Chum(luss) - A variety of ground geeb material packed in a ratchet to the tightness specified by the speaker
Honey Mustard - Gas dipping sauce
Ad Hominem - An argument that is directed against a person rather than the position they are maintaining (Ron)
Gamblers Fallacy - An erroneous belief that a random event is less or more likely to happen based on the results from a previous series of events (Ron)
Nik - Suffixtech
Nikolas/Nicholas - Nuclear Suffixtech
Nickel/nickel/nickeltech - Suffixtech
Sir - Suffixtech
Lore - Suffixtech
Tech - Suffixtech
The Flow of Pdellity - The eternal altering of Pdellas behavioral choices within his mind
The Pdella Effect - A phenomenon that occurs when Pdella alters the timeline of an event within his mind
Inpdellity - When Pdella Fugazi (never)
Granald Weezlir - Granny
Wanald Greezlir - Grandpa
DVloper - Granny Developer
Wocky Slush - Lean Slushie (That thang bleedin P)
The Mandeller Catalogue - Analog Horror web series
The Pdeller Catalogue - All of the instances of the Pdella effect
Cadderlac - Wilks old whip (RIP)
Fuck Folk - A potentially sad reactionary exclamation
I got a bag - But I aint braggin
I know these chubas mad - Because Im swaggin
Nudnik - A pestering, nagging, or irritating person; a bore
Ginnys Slur Bag - Ginnys pocket Ad Hominem
The Foam Guzzler - When an individual consumes an exorbitant amount of beer foam, particularly from a funnel (Cucumber Joe)
Shuster/Slush/Glo Time - The delaying of any conceivable event for as long as possible for no apparent reason
Nathan Sprague - Shit JMU CS professor (snitch)
Boozer - One who boozes
Malice - The intention or desire to do evil; ill will/nefarious acts
Chalice - A large cup/goblet, typically used for drinking grog
Chalice full of malice - A large cup/goblet chock full of malice
Buzz Lightyear - RL Shitter
Slim George - Crazy Wiz Courageous Bull
Slim George 4nem - Slim variant of George 4nem
Brandon the Barber - Certified OG Thug Shaker
Thug Shaker - One who thug shakes (Brandon the Barber)
Boner.com - A reactionary exclamation after witnessing Brandon the Barber
Lee Moser/Lee Mozer - Shusters Middle School PE Teacher, now Project Manager
Moe Monday - Crazy Moes promotional deal that occurs every Monday
Dark Ron - Rons alternate drunk form who Jaulps and causes mischief (liability)
Light Ron - The OG Cheeseman
Dark Slush - Slushs alternate drunk form who destroys things and causes mischief (liability)
Dark Fredi - Fredis alternate drunk form who blasts music and causes mischief (liability)
Dark JB^2 - JB^2s alternate drunk form who tears down blinds and invites random people into his apartment (liability)
Dim Fredi - Fredis alternate tipsy form who is a troll
Light Fredi - Fredis OG Form
Liar/LYRE/Leier - An accusatory exclamation for someone who is lying
Grillbob - Grilling Glo
Bennett Foddy - Narrator of Getting Over It With Bennett Foddy
Luss - Originally meant an extra amount of Keef on top of a geeb, however the meaning transitioned to mean any amount of extra weed on a geeb; Throwing caution to the wind
Double Chum - A geeb packed twice as full as usual
Double Chum (Hold the luss) - A DC (Double Chum) but you just slop a bunch more on
Triple Chum - A geeb packed thrice as full as usual
Triple Chum (Hold the luss) - TC (Triple Chum) but you just slop a bunch more on
Extra Chum - A geeb packed more than usual
Extra Chum (Hold the luss) - A geeb packed way more than usual; Traditionally in an unorthodox ratchet
Extra Luss (Hold the chum) - A geeb packed way more than usual with all keef
Balingitis - When one comes down with a case of Balignancy
Balingitic - When something has the property of being Balignant
Chalingitis - When one comes down with a case of Chalignancy
Chalingitic - When something has the property of being Chalignant
Malingitis - When one comes down with a case of Malignancy
Malingitic - When something has the property of being Malignant
Folklorish Periodic Table - A table that organizes all common, rare, and epic Earth elements according to many factors (Malignancy, Chalignancy, Bumlignancy, etc.)
Angel Garcia/Garseer/AG - Decent JMU Geo professor
Rare Earth Metal Balisingite - A rare Earth mineral that has yet to be recognized by AG
Rare Earth Metal Chalisingite - A rare Earth mineral that has yet to be recognized by AG
Rare Earth Metal Malisingite - A rare Earth mineral that has yet to be recognized by AG
Rare Shit Liquid Dud Pod - When the boof pod burns while still containing juice
Common Good Liquid Normal Pod - Normal boof pod
Chether Williams - Alternate form of Chester
Michael Stewart - Beast JMU CS professor
John Bowers/Jawn Bauers/JB^3 - Nutty JMU CS professor
Phillip Riler - Beast JMU CS professor
Slusher - Water
Secret Sprite - Sprite that is in the bottom drawer of Slushs fridge
Showcase Sprite - Sprite that is in the top 2 levels of Slushs fridge
PISS! - Piss
SHIT! - Shit
Asianfloorcream - Any mysterious substance found on the floor and below a certain elevation (Ancient)
The Glass Factor - An abstract concept originating from the depths of WBs mind (Ancient)
Boiled Chicken - Chicken that has been boiled in a pot of water (Ancient)
The light attracts the big chuba - The principle that Moths are attracted to light, especially the light emitted from a lighter/blunt (Ancient)
The trash bag is in the tub - When a trash bag is incorrectly placed in the bathtub instead of in the trash can (Ancient)
Terminator Toe Walking - Crazy substitute PE teacher walking style who has never once hit a leg day (Ancient)
Wizard Business - Playing Wizard101
LARPing - Live Action Role Playing
Jake Browning - 2023 Bengals player
DJ Chark Jr. - 2023 Panthers player
Nick Folk - 2023 Titans Kicker
Sam HOW - 2023 Commanders QB
Slug - Drink alcohol
Slugger - Someone who drinks alcohol in high volumes
Rodger Bumpass - Squidward voice actor
Dallas - Fuckin Hoes, Doin Shows
Joey Fatts - In love with Dallas
We Get High, We Get Fat - Unlimited by Lucki
House of Mid - Mid Harrisonburg barbershop
Charles - Crazy Uber Eats delivery driver
Chanellos/Chauuunellos - Crazy za and wingdings
Brothers - Decent Italian cuisine
AJs Gentlemans Barbershop - Crazy Harrisonburg Barbershop
Say That - A reactionary exclamation agreeing with what has been said
Seriously - A reactionary exclamation questioning the validity of a statement
Garber Hall - Crazy JMU on-campus dorm
Fredlan - Temporary bH slugger
Moorsee - Garber Hall soccer head
Cornball - Ron
Let Me See - If I can roll this blunt while Im drivin
Fruit Zhlushie - Shit Dragbar flavor
Vons Sleeping - Crazy RL Dropshot player
Staunton - Location South of Harrisonburg in Virginia
Down Syndrome 19 - COVID
Grog - Beer
Chaulmin Ultrasoft - Charmin Ultrasoft
Drew Petit - Good man and Farm client
Drew Hall - Beast Slugger
David Lemon - Crazy Farm client
Ridin Around in a Droptop with a Stolen Opp - NBA Studio session
Midmars - Mid Harrisonburg barbershop
Bobs - Michelob Ultra
Toner - Tony alter ego
Taco/Daco Bell - Mexican fast food restaurant
Don Pollo - The next station is: Fuck you my chuba
Mad - One Thousand USD
Mads of Cash - Multiple thousands of dollars
WHOPPERS! - Chocolate candy (Cap Day)
Mike WiLL Forged-It - AYO Mike Will
Scalamungralite - One that practices Scalamungral values
Scalamungral - Native Jaulp
Rate/Rate Rate/Reeheeheeheeheete - An inquisitorial statement inquiring for a rating on the relevant subject
Derp - Nalu alter ego
Chaulmingo - Nalu alter ego
Chethingite - A rare Earth mineral that has yet to be recognized by AG
Carlos Boozer - Insane retired basketball player
Bum/Clumford and Sons - Someone that is acting like a bumford/clumford
Andouille Sausage - Crazy Sausage
Balking - Another word for Bumming
Malignant - Malevolent or infectious
Chalicious - A synonym for malignant
Balificient - Something with Chalicious intent toward an individual
Belking - Skelking in a balificient way
Malking - Another word for Maulping
Jalking - Another word for Jaulping
Skelking - Another word for Scalping
Jelqing - Forbidden method of enhancing dick size
Clumford - One who engages in clummy acts
Clueford - One who frequently goes cluebar
Buford - One who engages in questionable acts
Bumford - One who engages in bummy acts
Jambalaya - A fire Cajun rice dish that consists of The Holy Trinity and Andouille Sausage
Gumbo - Crazy Cajun stew that consists of The Holy Trinity and Andouille Sausage that is served over rice
Roux - If you have never burnt the roux, then you have never made one
The Rocket Pass - Rocket League battle pass
Malmingralite - Someone who is going nuclear at the given time
Malisingralite - Having a verifiable 2-week nuclear streak
Malisungral Domain - The 7th circle of Hell
[Redacted] Domain 8 - The unspoken 8th circle of Hell
[Redacted] Domain 9 - The unspoken 9th circle of Hell
[Redacted] Domain 10 - The unspoken 10th circle of Hell
Bot - Ron
Botson - Jackson alter ego
Botmore - JB^2 alter ego
Jelqcope Goonmore - JB^2 alter ego
Coolhand - Caleb alter ego
TLC - The Lovettsville Crew (Cult)
Botley Crue - TLC
Nuclear - Something that goes hard af
Fredillionaire - Someone who is approaching the net worth of Fredi
Kevin Sr./Gevn Zenur - KJs Dad
Bunnel - A buffered funnel
WHAM! - Back to back, smack you right in your shit
Chester Dirtroot - A rootball that is extremely durable and is cast into a fire
Lester Stinklog - A rotting log that stinks and is cast into a fire
Hunt/UNT Showdown - Extraction-based shooter video game
Cluebar - Discovering a clue in Hunt Showdown
Crowbar -  Crows in Hunt Showdown
Fubar - Out of working order, perhaps irreparably damaged
Foobar - When someone is acting a foo, especially in Hunt Showdown
Dog/Ducktech - Dogs/Ducks in Hunt Showdown
Balkan breakfast - An entire sandwich disassembled in its raw ingredients eaten separately
The German stare - When an individual of German heritage stares at you
Vietnamese tiptoe - When an individual of Vietnamese heritage tiptoes in any direction
Old World Pepperoni - Crazy old-style pepperoni (Fuck Old World Sausage)
Old World Sausage - Dogshit old-style sausage
Chad - Someone with extreme motion, they get hella bitches and money
Beta - Someone with no motion, they get no bitches or money regardless of the situation
Chud - One who has more motion than a Beta, but less motion than a Chad
Chud Motion Fr - When someone gets no bitches and/or money consistently
F/GILMCL - Fuck/God I love my chud life
FMCL - Fuck my chud life
F/GILC - Fuck/God I love Crosby
FILC - First in line chuffer
GILC - God I love chuffing
TCLCBSBIYWLI - This chud life could be so beautiful if you would let it
JM - Jersey Mikes
CTELA - JM #13 with Swiss, capicola, mayo, bacon, and cherry pepper relish all done Mikes way
Tangerang - Capicola, salami, pepperoni, cherry pepper relish, and banana peppers all done Mikes way
The Whole Pig - Provolone, turkey, lettuce, mayo, salt, pepper, and a metric fuckton of bacon
Bufordtonian/Big Buford - A slice of ham and turkey on the grill for 1 hour, tomato on the grill, 1/4 lb blue cheese, 1/4 lb mustard, 1/8 lb hot sauce, pickle, 1/4 lb oil, let it sit on the grill for 90 minutes, then ferment for an entire day
Chicken/Steak Club Bob - Mayo, lettuce, tomato (fuck tomato), bacon, added to a JM #16 or #17. Substitute provolone for American
Meatball Sub - Slicer scraps compacted into balls. Comes with whatever cheese is on the slicer
Black Italian - JM #13 but you put that shit on the grill for 2 minutes, add mayo
Snake and Cheese - Fresh black snake grilled to perfection with Swiss cheese, lettuce, and tomato
Bug Sandwich - Any type of sub with lettuce that is infested with small bugs (rare occurrence but has happened)
Smoky South Chester - Regular SW with bacon, lettuce, and cherry pepper relish
Picky Guys Fav - Club supreme with light lettuce but not too light, ripe tomatoes, little to no mayonnaise, crispy bacon, and spit. Cut into 1/4 and 3/4
Trash Sub - Trash from the lobby trash can is placed into a sub roll, topped with degreaser and dish soap
Jims Way - 1/4 lb of mayo and 1/4 lb of mustard
Bufords Way - Mikes way no tomato (fuck tomatoes) with mayo, cherry pepper relish, and banana peppers
Big Buford - JM #6 with white American cheese subbed and pickles, onion, lettuce, and tomato
Coleman Special - JM #31 on gluten-free with no cheese, lettuce, mayo, or tomato
The Bubble Bass - Any hot sub with grilled pickles
Jersey Cream - Your choice of bread injected with mayo
Crunchy - Burnt, rock-hard bread that has been sitting out all day (Wren tech)
Stale Grill Bread - Bread that Jasmine (Buford) still thinks we need to sell even though its not edible
Buford Bite - Rolled up rosemary parm bread with salami, cheese, oil, and oregano that is grilled
Buford Patty - A tomato slice with cheese that is completely burnt on the grill for at least 30 minutes
Sun Dried Bread - Bread that is left out in the sun to dry for a variable amount of time
The Hot Four - JM #4 on the grill with an absurd amount of hot sauce, vinegar, and cherry pepper relish
Kens Dip - One of the best ranches of all time (Comes with Chanellos za)
Mega Bob - A beer funnel mixed with a shot of liquor or some wine (Equivalent to 2 standard drinks)
Giga Bob - A beer funnel mixed with a shot of liquor and some wine (Equivalent to 3 standard drinks)
Ultra Bob - A beer funnel mixed with 2 shots of liquor and wine (Equivalent to 4 standard drinks)
Sigma Bob - A beer funnel mixed with whatever you want (Equivalent to n standard drinks)
Double R - Completely botted and dogshit usurpers (roommates) that have left a blight on the B00n House, effectively giving it Scarlet Rot
B00n House - Any residence that houses multiple B00n members at once
B00n House Founding (Alpha) Chapter - JMU off-campus apartment at The Hills Southview; Housed: Slush, Sheister, Fredi, and Glo
B00n House Radford (Beta) Chapter - Radford off-campus apartment at University Square; Housed: JB^2 and Botson
Double R Produced It - A statement to announce Double Rs most recent fuckup
B00n Clan - Our gang of day 1 folks; A council of Chesters, Jaulpers, and Scalpers
Glotiggy - Rowan alter ego
Chuba - Nigga
Chuber - Nigger
Crot - Cort alter ego
3 Funnel Crot - Crot after taking 3 funnels
10 Funnel Crot - Crot after skiing and taking 10 funnels
Its time to go paint - Go get all the brushes
Ronald Klanzman - Brennan alter ego
Ronald Klanzball - Brennan alter ego
Ronald Racecar - Brennan alter ego
Ronald Cheese - Brennan alter ego
Ronald Cheeseball - Brennan alter ego
Bicky Wicky - Jacob Bickmore alter ego
Huzz - A woman that is attractive and/or desired
Chuzz - Chopped huzz, opposite of a normal huzz
Bruzz - A bro/homie
Chuff - Vape
Boof - Vape
Dr Chuff - Nadeem alter ego
Cheeze - A busted/unfair strategy that is often annoying to counter
Coping - Dealing with and attempting to overcome a problem or difficulty
Roping - Ron coping
Cold Cuisine - Hes not amused
Doordash left him - Feeling used
Standard Rating Scale (SRS) - A scale from 0 to 10 on which topics are rated based on quality
-10 (Rating) - Something completely and utterly diabolical (breaks the SRS)
0 (Rating) - Something that is extremely horrible and has no redeeming qualities whatsoever (Lowest standard rating)
1 (Rating) - Something that is quite bad but not the worst
2 (Rating) - Something mid, mostly bad with 1 or 2 redeeming qualities
3 (Rating) - Also something mid, but with more than 2 redeeming qualities
4 (Rating) - Something that is on the brink of being good, but with undesirable drawbacks
5 (Rating) - Something that has qualities of a 10 and also a 0, averages to 5 ((0 + 10) / 2 = 5)
6 (Rating) - Something good that is slightly above average
7 (Rating) - Something good that is notably above average
8 (Rating) - Something excellent, its good qualities cannot be denied
9 (Rating) - Something superb that has little to no bad qualities
10 (Rating) - Something that is incredible and amazing, has no bad qualities whatsoever (Highest standard rating)
Bet it all on green - Lost it just like that
Cheeseman dreams unseen - Gone in a snap
Baliming Dynasty - The first dynasty of Ancient Jaulmer Springs, witnessed the birth of Jaulses Chest (0-1000 AD)
Balising Dynasty - The second dynasty of Jaulmer Springs, these were dark times where Folklorish was repressed (1001-2002 AD)
Balisong Dynasty - The third and current Dynasty of Jaulmer Springs, ushered in the age of Folklorish (2003-Present)
Tronald Wheeze - Brennan alter ego
Ronald Cheesewax - Brennan alter ego
Ronald Cheesemaxington - Brennan alter ego
Folklorish - The culture of B00n Clan
Mumford and Sons - I WILL WAIT, I WILL WAIT, FOR YOU (Screaming into the mic)
Snoozer - Someone who frequently snoozes (Ex. Ron and Glo)
Snoozer Male - Super rare and better than Alpha
Dozer - Someone who frequently dozes off (Ex. Pdella and Glo)
Glo Botbert - Rowan alter ego when hes being a bot
Botbert Secret - Originating from Glo Botbert, something that is intentionally gatekept for unknown reasons
Bar Louie - Ashburn bar that turns into a night club with wannabe clubbers/crawlers
Fat Shite - Cort
Fine Shite - Slush
You're a fucking homosexual and I'm gonna hang you - Faggot, chuber! chuber! chuber!
Salt Bombs/Zalt Bahms - B00n style chicken tenders that contain a borderline inedible amount of salt and Lawry's seasoning salt
PhileyCheeseJr - Dogshit Dropshot player that can't spell
Cope Cave/Cope Central/Cope City/Cope Capital - Ron's room
Donald Cheeze/Ghee/Duck - Brennan alter ego
Trog Gaming Theorem - When a specific trog game is played that holds troglodyte/oger/discord mod qualities and turns whoever plays said game into a trog player (Coined by JB^2, 2025)
Trog Games - Including but not limited to: Rust, Valorant, Tarkov, Marvel Rivals, Overwatch, and GayZ
Trog Players - Including but not limited to: Ron, Scware, KJ (sometimes), Fredi, Gav120, Lil Rusty, Pdella, Price, and Glo
Super Meat Boy/Zuper Meet Boi - Fire platforming game that is incredibly difficult to 100%
Early Bird Theorem - "Early to bed, early to rise makes a man retarded, fat, and wise" (Coined by Glo, 2024)
Night Owl Theorem - "Late to bed, late to rise makes a man retarded, fat, and high" (Coined by Slush, 2024)
JB^2 Nazi Theorem - "I'm ngl if I were born in in the late 1930s/early 1940s I'd definetly be a nazi" (Coined by JB^2, 2024)
Cort Likes Dick Theorem - This is in reference to the fact that Cort is a closeted gay and he would like dick if he could in 30 years (Coined by Slush, 2024)
Enhanced Ass Eating Theorem - "Stick a jolly rancher in a girl's asshole to eat ass with a better flavor" (Coined by JB^2, 2024)
AVL Theorem - An AVL tree with n nodes has O(log n) height (Coined by Ron, 2023)
Chinese Fairytale - Shuster's perspective on any anime/manga regardless of its actual country of origin
Geeb Theorem - 1 geeb = thinking^2 (Coined by JB, 2023)
Cort's House Theorem - “Cort’s house would be a crazy map” (Coined by Balasha, 2021)
Balasha - Lucas alter ego
JB Trashbag Theorem - "I would fuck a thick trashbag" (Coined by JB, 2021)
Devon Farley Theorem - "Devon Farley is the real life Wall of Flesh" (Coined by Wilky, 2021)
Wilky - Ryan alter ego
Woodgrove Theorem - "Woodgrove has a metal skeleton" (Coined by Wilky, 2021)
Free College Theorem - Just show up to random lecture halls and pretend you go to the school (Coined by Shuster, Ron, and Fredi, 2021) (Implemented by Slush, 2025)
Sauna Theorem - "Get the fuck out the sauna if you didn't pump stupid bitch" (Coined by Lil Rav, 2021)
Lil Rav - Keyan alter ego
Eyelid Theorem - "Eyelids are impervious to metal" (Coined by JB, 2021)
The Essential Plane - B00n Discord server and the meeting place of all scalpers
Paul is Retarded Theorem - All questions can be answered by saying Paul is retarded (Coined by Wilky, 2021)
Filler Word Theorem - "Like is just the filler word for white people like the n word is for black people" (Coined by Cort, 2021)
Simp - Sucka idolizing mediocre pussy
Simps - Including but not limited to: Jeff, Cort, Paul (sometimes), and JB (sometimes)
Simping - The act of being a simp, especially if it is done frequently
Bonaban - Johnny alter ego
No Gas Theorem - This is in reference to the fact that one cannot purchase weed if they can't fuel their vehicle beforehand (Coined by Slush, 2021)
Chief Keef is Beast Theorem - This theorem states that Chief Keef is insanely beast because he has 38 albums and he defines his own reality by defying traditional logic (Ex. “I’m a eagle, not a bird”) (Coined by Shuster, 2019)
Mini Bic Lighter Theorem - "Mini Bic lighters are op, absolutely busted" (Coined by Bonaban, 2019)
Scware Theorem - Scware doesn't know where or what Harry Byrd Highway is. My brother is 7 and he knows what Harry Byrd Highway is. This theorem states that scware has been locked in his basement his whole life and he only knows where the church, baseball field, and school are. (Coined by Shuster, 2019)
Mitosis Theorem - "Mitosis be like: o 0 8 oo" (Coined by Bonaban, 2019)
Fire Theorem - "Fire doesn't hurt, it just does damage" (Coined by Pdella, 2019)
Close Enough Theorem - "It's close enough" (Coined by Bonaban, 2019)
Kodak is Gay Theorem - This is in reference to the fact that Kodak is gay because he said wanted to "clap a nigga cheeks" (Coined by Bonaban, 2019)
DM - Domain (Ancient)
Zombies are Tards Theorem - "Zombies are actually tards because they sprint around swinging their arms all over the place and scream incomprehensible battle cries" (Coined by Bonaban, 2019)
Sleep Equals Death Theorem - "When you go to sleep, you're actually dead. When you wake up, its just God inviting you back to the game." (Coined by Jeff, 2019)
Jeff - Walker alter ego
The Improved Gay Sex Theorem - "2 gay people having gay sex is gay because negative times negative over negative is still negative making it gay. The third negative comes from the gay sex, so if 2 gays have regular sex it would not be gay because negative times negative over positive is positive making it not gay." (Coined by Bonaban, 2019)
Nuclear Nicholas - Someone/thing that goes undeniable hard
Dewford Town - Crazy Pokemon location
Chad Gaming Theorem - When a specific game is played that holds chad/alpha/sigma qualities and turns whoever plays said game into a chad player. (Coined by Slush, 2025)
Chad Games - Including but not limited to: Cuphead, Super Meat Boy, Minecraft, Skate 3, BO2, BO3, any Fromsoft game, Terraria, Rocket League, any Granny game, Wizard101, GD, Subnautica, any FNAF game, any DOOM game, most pokemon games
Chad Players - Including but not limited to: Slush, KJ (sometimes), JB^2, Cort, and JB
1:14 that piano - The piano sample in the song "Like 34 & 8" by Gucci Mane ft. Pooh Shiesty (at 1 minute, 14 seconds)
1:16 that saxophone - The saxophone sample in the song "troy bolton" by Tockyy (at 1 minute, 4 seconds (contrary to the name))
Crazy Nigga 1 - A YN going nuclear on the piano
Crazy Nigga 2 - Thotiana piano earrape
Hear ye Hear ye ahh beat - French Montana showing Future his horrible beat
Yessir Ronald Cheese - Ron's go to stim for any occasion
Tim Cheese - Allegedly killed John Pork
John Pork - A virtual pig influencer who often calls others
Dequavious Pork - An alternate reality black John Pork
Dequavious Pork Pay - A contactless payment method, similar to apple pay, except DPP works everytime and is based on the viral influencer Dequavious Pork
Chromebook Durability Test - A method of determining the structural integrity of a Chromebook, which involves hurling it at the bathroom wall multiple times so that all of the pieces scatter into the urinals
Chrish - Insane IG singer known for classics such as: A oo oh oo, appyyyy earrrrr ofmuhlife; Ehh ehh ehh ehh ehh ehh, ehh ehh ehh ehh ehh ehh ehh; & I just wanna be part of your symphonyyyyyyyy
John Torque - Insanely posted character from Vigilante 8
Sir Blazin, Sir Blazin - Hottest Halal plug in the DMV
Haraz Coffee House - Local coffee store opening up in Fairfax County, VA
Flow State Calculation Theorem - This theorem states that for every individual there is a perfect amount of drug consumption (drinking, smoking, etc.) to achieve an ideal mental state of Zen. This amount is different for every person, but can be easy calculated by gradually increasing consumption of the desired substance until the Flow State is reached. (Coined by Slush, 2025)
The Scalping Hour - An arbitrary hour of the day (usually betweem 11 pm and 3 am) in which hella folks hop in disc and start scalping uncontrollably, most frequently exhibited by one of the three scalpers (Slush/Ron/JB^2).
The Jaulping Hour - An arbitrary hour of the day (usually betweem 11 pm and 3 am) in which hella folks hop in disc and start jaulping uncontrollably, most frequently exhibited by one of the three scalpers (Slush/Ron/JB^2).